1111111111
1000001201
1011101101
1110000001
1010101101
1000100101
1111111101
1100010001
1001000111
1011111111