1111111111
1000000021
1010101011
1111111011
1100001001
1001101101
1110000001
1111111101
1000000001
1011111111