1111111111
1000001201
1011101101
1001000001
1101011101
1101010001
1001010101
1011111101
1000100001
1011111111